          #####
          ###*#
        ##### #
        # ### #
############# #
#    #@  *    #
############  #
          ##  #
          #####
