          #####
          ###.#
        ##### #
        # ### #
############# #
#    #@  $    #
############  #
          ##  #
          #####
