######
#    #
#    #
#    #
#    #
#  @ #
#  $ #
#   .#
######