########
#     .#
# .$@  #
#   $  #
#      #
########