########
#     .#
# *$@  #
#      #
########