########
# @    #
# *$   #
#     ##
#.    #
#######