####################
#            .     #
#   $   . $     $  #
#     $      $     #
#   ##################################
#  @         $                   .   #
#  $ .         .       *             #
#        .     .                 *   #
#############################################