####################
#                  #
#         $        #
#                  #
#                  #
#  @               #
#                  #
#              .   #
####################