####################
#            .     #
#   $   .       $  #
#     $      $     #
#   ##################################
#  @         $
#  $ .         .
#        .     .
#############################################