####################
#            .     #
#   $              #
#                  #
#   ################
#  @         $     #
#                  #
#              .   #
####################